***************
*             *
*             *
*             *
*     !!!!!!!!*
*     !!!!!!!!*
*     !!!!!!!!*
*     !!!!!!!!*
*             *
*             *
***************
